P,0,0,1,1,E,0,0
0,0,0,1,1,W,W,0
0,W,0,1,1,0,0,0
0,W,0,1,1,0,W,W
0,W,0,1,1,0,0,0
0,W,0,1,1,W,W,0
0,0,1,1,1,1,0,0
0,0,0,0,0,0,0,0
